XXXXXXXXXXX
XX   H   XX
X X XXX X X
X X  X  X X
X  X   X  X
XX   X   XX
X  X X X  X
X  X   X  X
X XXX XXX X
X    F    X
XXXXXXXXXXX